1111111111111
11DDDDDDDDDD1
1000011111101
1P0001E00C101
1111111111111