1111111111111
10000D0000001
1000011111101
1P0000E00C101
1111111111111