1111111111111
1D0000D000001
1000011111101
1P0001E00C101
1111111111111