11111111111111111111111111111
1E0000000000000C0011111111111
10100101001000001011111111111
10100100101010100011111111111
1P0000000C00C0000011111111111
11111111111111111111111111111