111111111111111
100C00000000001
100000000DD0001
100000000000001
100000000000001
100000000000001
100000000000001
1000000P0000001
100000000000001
100000000000001
100000000000001
100000000000001
100000000000001
100000000000E01
111111111111111
